####################
####################
###.@......a..######
########0#######!###
########..b#####.###
###...1###.#####.###
###.##.....#####2###
###.############.###
###.....c........###
####################