###############
###############
#.@.........###
######.########
######...######
#....###.######
#.##.....######
#.#############
#.............d
###############