###############
###############
#.@.........###
#####...#######
#####...#######
#####...#######
#####...#######
#####...#######
#..............
###############