#############
#############
#.@.........#
######.######
######.######
######.######
######.######
######.######
#...............     ...........##
################     #######.#####