####################
####################
###.@......a..######
########0#######..!#
########..b##.##.###
#/#...1###.##.d#.###
#.#.##......#.##2###
#3#.#########.##.###
#.......c........###
####################