#############
#############
#.@.........#
#####...#####
#####...#####
#####...#####
#####...#####
#####...#####
#...............     ...........##
################     #######.#####