###############
###############
#.@......b..###
######c########
######...######
#....###.######
#.##.....######
#.#############
#.............d
###############