###############
###############
#d.........####
##########.####
####... ...####
####.##########
####...########
######.########
#@.....########
###############
