#################
#################
#.......  ......#
##############.##
######.....###.##
######.###.....##
######.##########
######.##########
#@.....##########
#################