####################
###.............!###
###.################
###.##.....#########
###..1.###0##.b#####
###.######.##.######
##/.##.a......######
######.####.########
####@..####../######
####################