####################
#..............###.!
#.####.##1##.#.c##.#
#.####.##.##.#####.#
#....#.##.##/#####.#
##.#.#.b#.########.#
#/.#.####..2.......#
####0############.##
@......a.######/..##
####################