####################
#..............###.!
#.####.##1########.#
#.####.##.########.#
#....#.##.########.#
####.#.b#.########.#
####.####..........#
####0###############
@......a.###########
####################