####################
#@....###..........#
#.###.###.########.#
#.#/#.###.###..2..c#
#a#.#b....#/..##.###
#.#.####.#######.###
#...###.1....###.###
##0##/#.####.#/..###
##.##.#.####.......!
##....##############