####################
###/###.....2......!
#/#..##.#####.#.####
#.##.##b#.a.#.#.####
#.##.##.#.#.#.#.####
#.......#@#.#.#.#/##
##.####.###.#.#.#.##
##.##/#..0..#.#.#.##
##1...#/..###...c.##
####################