..a.....#....##.....
@###0#.##.##.##.##/#
####/#.##.##.##2####
######....#b....####
/######.####1##c#./#
.###.##.####.####.##
...3....####.###....
#.##.####.......4##.
#.##.####.#####.##..
/.#d.####!#####e#/.#
